    _   ___            __     ___
   / | / (_)   _____  / /    <  /
  /  |/ / / | / / _ \/ /     / / 
 / /|  / /| |/ /  __/ /     / /  
/_/ |_/_/ |___/\___/_/     /_/   
                                 