███    ██ ██ ██    ██ ███████ ██           ██ 
████   ██ ██ ██    ██ ██      ██          ███ 
██ ██  ██ ██ ██    ██ █████   ██           ██ 
██  ██ ██ ██  ██  ██  ██      ██           ██ 
██   ████ ██   ████   ███████ ███████      ██ 
                                 